111111111111
111111111111
111111111111
000000000000
000000000000
000000000000
111100001111
111100001111