0000000000000000000
0000001111111000000
0000011111111100000
0000011111111100000
0000011011101100000
0000011011101100000
0000011111111100000
0000000111110000000
0000000101010000000
0000000101010000000